1111111111111
10010000001C1
10000111101E1
1P00110000001
1111111111111
